District,Poll Number,Poll Name,Susan Barclay,Bill Brown,Carl Chaboyer,Roger Valley,Rejected Ballots,Total Vote,Electors
Kenora/Kenora,1,Fort Severn 89,18,4,2,78,0,102,219
Kenora/Kenora,2,Bearskin Lake,7,1,0,84,0,92,224
Kenora/Kenora,3,Big Trout Lake,41,1,1,43,0,86,467
Kenora/Kenora,4,Wapekeka 1,45,5,9,44,1,104,175
Kenora/Kenora,5,Kasabonika Lake,65,7,5,77,0,154,356
Kenora/Kenora,6,Webequie,66,2,4,110,2,184,347
Kenora/Kenora,7,Summer Beaver,79,0,1,50,0,130,197
Kenora/Kenora,8,Wunnummin Lake,53,3,2,92,0,150,258
Kenora/Kenora,9,Wawakepewin,0,0,0,0,0,0,7
Kenora/Kenora,10,Kingfisher Lake 1,20,1,1,151,1,174,222
Kenora/Kenora,11,Weagamow Lake 87,151,8,5,26,0,190,373
Kenora/Kenora,12,Pickle Lake,46,51,6,25,1,129,271
Kenora/Kenora,13,Neskantaga (Lansdown House),12,1,3,77,0,93,127
Kenora/Kenora,14,Fort Hope 64,49,5,1,142,5,202,554
Kenora/Kenora,15,Osnaburgh 63A,17,6,5,22,0,50,227
Kenora/Kenora,16,Savant Lake,5,7,1,5,0,18,73
Kenora/Kenora,17,Sachigo Lake 1,14,2,2,69,0,87,238
Kenora/Kenora,18,Sandy Lake 88,20,4,5,119,0,148,284
Kenora/Kenora,19,Sandy Lake 88,37,4,6,144,0,191,570
Kenora/Kenora,20,Keewaywin,14,7,6,50,0,77,98
Kenora/Kenora,21,Muskrat Dam Lake,34,1,1,39,0,75,131
Kenora/Kenora,22,North Spirit Lake,19,4,0,46,4,73,144
Kenora/Kenora,23,Deer Lake,87,2,3,70,0,162,403
Kenora/Kenora,24,Poplar Hill,29,11,7,84,1,132,176
Kenora/Kenora,25A,Pikangikum 14,18,1,0,7,0,26,397
Kenora/Kenora,25B,Pikangikum 14,25,0,0,4,0,29,272
Kenora/Kenora,26,Madsen,25,11,6,13,0,55,94
Kenora/Kenora,27,McKenzie Island,24,6,1,12,0,43,69
Kenora/Kenora,28,Red Lake,81,60,12,85,1,239,379
Kenora/Kenora,29,Red Lake,70,36,7,68,1,182,397
Kenora/Kenora,30,Cochenour,75,53,4,60,0,192,367
Kenora/Kenora,31,Balmertown,56,42,5,70,0,173,305
Kenora/Kenora,32,Red Lake,29,36,5,51,2,123,280
Kenora/Kenora,33,Red Lake,64,45,15,37,0,161,418
Kenora/Kenora,34,Balmertown,101,38,6,75,0,220,461
Kenora/Kenora,35,Balmertown,51,22,1,49,0,123,199
Kenora/Kenora,36,Ear Falls,63,55,5,19,1,143,302
Kenora/Kenora,37,Ear Falls,54,62,9,47,1,173,374
Kenora/Kenora,38,Ear Falls,24,35,2,20,0,81,160
Kenora/Kenora,39,Cat Lake 63C,25,4,1,34,2,66,202
Kenora/Kenora,40,Slate Falls,24,1,2,8,0,35,77
Kenora/Kenora,41,Islington 29,33,5,4,58,3,103,397
Kenora/Kenora,42,Grassy Narrows,19,4,34,31,0,88,309
Kenora/Kenora,43,Minaki,16,32,6,34,0,88,141
Kenora/Kenora,44,Pellatt,44,52,4,34,0,134,222
Kenora/Kenora,45A,Jaffray and Melick,48,67,10,64,3,192,298
Kenora/Kenora,45B,Jaffray and Melick,13,0,1,29,0,43,96
Kenora/Kenora,46,Redditt,32,21,7,18,1,79,113
Kenora/Kenora,47,Jaffray and Melick,55,66,8,46,0,175,311
Kenora/Kenora,48,Machin,Merged with No. 49A,,,,,,28
Kenora/Kenora,49A,Machin,52,62,5,30,0,149,252
Kenora/Kenora,49B,Machin,53,77,6,45,0,181,311
Kenora/Kenora,50,Longbow Lake,82,140,17,110,1,350,524
Kenora/Kenora,51,Jaffray and Melick,53,71,11,28,1,164,302
Kenora/Kenora,52,Jaffray and Melick,66,107,13,53,2,241,458
Kenora/Kenora,53,Jaffray and Melick,55,53,14,51,0,173,311
Kenora/Kenora,54A,Jaffray and Melick,59,84,2,70,0,215,386
Kenora/Kenora,54B,Jaffray and Melick,44,64,6,68,1,183,343
Kenora/Kenora,55,Jaffray and Melick,79,74,11,70,1,235,399
Kenora/Kenora,56,Keewatin,77,73,17,52,2,221,368
Kenora/Kenora,57A,Keewatin,75,61,9,62,2,209,382
Kenora/Kenora,57B,Keewatin,74,68,6,61,1,210,425
Kenora/Kenora,58A,Keewatin,47,61,9,50,0,167,267
Kenora/Kenora,58B,Keewatin,42,56,4,56,1,159,264
Kenora/Kenora,59,Laclu,75,54,7,53,0,189,268
Kenora/Kenora,60A,Shoal Lake (Part) 39A,25,0,2,20,0,47,129
Kenora/Kenora,60B,Shoal Lake (Part) 39A,6,0,0,5,0,11,135
Kenora/Kenora,60-1,Clearwater Bay--Granite Lake,20,65,4,20,0,109,163
Kenora/Kenora,61,Keewatin,52,62,2,71,1,188,310
Kenora/Kenora,61-1,Rat Portage 38A,21,0,1,13,0,35,39
Kenora/Kenora,62,Kenora 38B,11,1,3,38,0,53,150
Kenora/Kenora,63,Northwest Angle 34C & 37B,3,1,0,6,0,10,24
Kenora/Kenora,64,Sioux Narrows,49,90,4,74,0,217,382
Kenora/Kenora,65A,Whitefish Bay 32A,1,0,0,9,0,10,19
Kenora/Kenora,65B,Whitefish Bay 32A,15,1,3,44,0,63,270
Kenora/Kenora,66,Nestor Falls,34,80,0,32,3,149,179
Kenora/Kenora,67,Onegaming,29,0,3,61,0,93,245
Kenora/Kenora,68,Kenora,63,69,8,50,1,191,372
Kenora/Kenora,69,Kenora,30,54,7,57,1,149,236
Kenora/Kenora,70,Kenora,75,33,6,44,1,159,349
Kenora/Kenora,71,Kenora,72,40,11,57,2,182,371
Kenora/Kenora,72,Kenora,77,28,5,47,3,160,369
Kenora/Kenora,73,Kenora,72,45,6,49,0,172,359
Kenora/Kenora,74,Kenora,86,62,6,79,3,236,434
Kenora/Kenora,75,Kenora,51,40,9,43,0,143,326
Kenora/Kenora,76,Kenora,45,33,3,46,1,128,327
Kenora/Kenora,77,Kenora,54,87,7,89,1,238,399
Kenora/Kenora,78,Kenora,92,61,3,51,2,209,379
Kenora/Kenora,79,Kenora,75,96,16,109,6,302,536
Kenora/Kenora,80,Kenora,43,28,4,54,0,129,225
Kenora/Kenora,81,Kenora,67,57,6,84,2,216,348
Kenora/Kenora,82,Kenora,34,43,4,34,0,115,258
Kenora/Kenora,83,Kenora,46,63,15,86,0,210,381
Kenora/Kenora,84,Kenora,62,45,11,45,1,164,325
Kenora/Kenora,85,Kenora,28,64,8,52,5,157,307
Kenora/Kenora,85-1,Kenora,63,60,4,58,0,185,307
Kenora/Kenora,86,Kenora,59,86,11,71,4,231,444
Kenora/Kenora,87,Quibell,34,42,3,21,0,100,193
Kenora/Kenora,88,Rugby Township,51,72,8,55,0,186,438
Kenora/Kenora,89,Wabigoon,33,50,0,27,1,111,191
Kenora/Kenora,90,Wabigoon,69,64,13,44,3,193,271
Kenora/Kenora,91A,Dryden,58,56,8,66,1,189,338
Kenora/Kenora,91B,Dryden,29,75,9,39,2,154,291
Kenora/Kenora,92A,Dryden,37,66,8,41,0,152,282
Kenora/Kenora,92B,Dryden,37,45,6,42,0,130,255
Kenora/Kenora,93,Two Mile Corner,36,36,0,51,0,123,246
Kenora/Kenora,94,Dryden,68,47,9,67,0,191,371
Kenora/Kenora,95A,Dryden,33,59,3,64,1,160,300
Kenora/Kenora,95B,Dryden,41,45,8,61,0,155,290
Kenora/Kenora,96,Dryden,72,79,5,116,0,272,426
Kenora/Kenora,97,Dryden,47,62,6,79,0,194,348
Kenora/Kenora,98,Dryden,23,42,7,75,1,148,298
Kenora/Kenora,99,Dryden,53,76,6,84,1,220,363
Kenora/Kenora,100,Dryden,51,68,10,131,0,260,370
Kenora/Kenora,101A,Dryden,35,65,6,67,0,173,304
Kenora/Kenora,101B,Dryden,28,38,3,67,0,136,269
Kenora/Kenora,102,Dryden,51,83,11,104,1,250,453
Kenora/Kenora,103,Dryden,35,48,6,59,1,149,281
Kenora/Kenora,104,Dryden,37,61,7,51,2,158,307
Kenora/Kenora,105,Dryden,45,48,5,88,0,186,375
Kenora/Kenora,106,Dryden,61,70,5,80,1,217,547
Kenora/Kenora,107,Dryden,84,85,7,70,1,247,522
Kenora/Kenora,108,Two Mile Corner,47,50,4,45,0,146,277
Kenora/Kenora,109,Oxdrift,61,96,8,72,0,237,357
Kenora/Kenora,110,Minnitaki,22,1,5,24,0,52,136
Kenora/Kenora,111,Eagle River,98,78,11,101,2,290,465
Kenora/Kenora,112,Dinorwic,30,30,1,17,0,78,124
Kenora/Kenora,112-1,Wabigoon Lake 27 ,13,5,1,22,0,41,72
Kenora/Kenora,113,Sioux Lookout,72,66,5,62,1,206,474
Kenora/Kenora,114A,Sioux Lookout,40,48,10,33,2,133,263
Kenora/Kenora,114B,Kenora, Unorganized,37,26,2,43,1,109,255
Kenora/Kenora,115,Lac Seul 28,41,5,5,27,0,78,151
Kenora/Kenora,116,Sioux Lookout,28,22,2,22,1,75,167
Kenora/Kenora,117,Sioux Lookout,74,35,2,72,0,183,435
Kenora/Kenora,118,Sioux Lookout,46,27,9,35,0,117,257
Kenora/Kenora,119A,Sioux Lookout,60,24,8,33,3,128,245
Kenora/Kenora,119B,Sioux Lookout,63,21,9,34,1,128,276
Kenora/Kenora,120,Sioux Lookout,38,28,3,41,0,110,295
Kenora/Kenora,121,Sioux Lookout,95,43,6,48,0,192,393
Kenora/Kenora,122A,Sioux Lookout,65,28,9,27,1,130,278
Kenora/Kenora,122B,Sioux Lookout,52,34,5,38,0,129,225
Kenora/Kenora,123,Sioux Lookout,63,42,9,43,0,157,310
Kenora/Kenora,124,Valora,5,3,2,0,0,10,16
Kenora/Kenora,125,Ignace,19,19,3,14,0,55,161
Kenora/Kenora,126,Ignace,100,42,10,43,2,197,456
Kenora/Kenora,127,Ignace,55,27,0,43,1,126,309
Kenora/Kenora,128,Ignace,52,31,2,24,0,109,255
Kenora/Kenora,500,Mobile poll/Bureau itinérant,14,11,3,15,2,45,75
Kenora/Kenora,501,Mobile poll/Bureau itinérant,Void,,,,,,
Kenora/Kenora,600,Sioux Lookout,120,87,13,95,0,315,
Kenora/Kenora,601,Red Lake,64,60,4,74,1,203,
Kenora/Kenora,602,Ear Falls,17,22,2,16,0,57,
Kenora/Kenora,603,Kenora,108,140,11,114,3,376,
Kenora/Kenora,604,Kenora,104,120,14,110,1,349,
Kenora/Kenora,605,Dryden,157,254,11,267,1,690,
Kenora/Kenora,606,Ignace,47,25,0,31,1,104,
Kenora/Kenora,,Group 1/Groupe 1,13,27,5,29,5,79,127
Kenora/Kenora,,Group 2/Groupe 2,119,149,5,123,2,398,
