Electoral District/Circonscription,Polling Station Number/Numéro du bureau de scrutin,Polling Station Name/Nom du bureau de scrutin,Ken Bell,Jim Comiskey,Kathleen Kevany,Dave Van Kesteren,Rejected Ballots/Bulletins rejetés,Total Votes/Total des votes,Electors/Électeurs
"Chatham-Kent--Essex/Chatham-Kent--Essex"," 1","Leamington",14,50,52,139,0,255,411
"Chatham-Kent--Essex/Chatham-Kent--Essex"," 2","Leamington",7,24,39,85,0,155,277
"Chatham-Kent--Essex/Chatham-Kent--Essex"," 3","Leamington",5,38,25,91,0,159,301
"Chatham-Kent--Essex/Chatham-Kent--Essex"," 4","Leamington",7,58,52,122,1,240,408
"Chatham-Kent--Essex/Chatham-Kent--Essex"," 5","Leamington",5,52,34,126,0,217,422
"Chatham-Kent--Essex/Chatham-Kent--Essex"," 6","Leamington",9,59,29,73,4,174,377
"Chatham-Kent--Essex/Chatham-Kent--Essex"," 7","Leamington",5,35,27,99,1,167,304
"Chatham-Kent--Essex/Chatham-Kent--Essex"," 8","Leamington",6,20,19,72,1,118,200
"Chatham-Kent--Essex/Chatham-Kent--Essex"," 9","Leamington",9,37,58,148,1,253,448
"Chatham-Kent--Essex/Chatham-Kent--Essex"," 10","Leamington",7,34,27,63,0,131,235
"Chatham-Kent--Essex/Chatham-Kent--Essex"," 11","Leamington",4,78,28,97,1,208,393
"Chatham-Kent--Essex/Chatham-Kent--Essex"," 12","Leamington",10,101,29,98,2,240,407
"Chatham-Kent--Essex/Chatham-Kent--Essex"," 13","Leamington",10,98,26,67,2,203,365
"Chatham-Kent--Essex/Chatham-Kent--Essex"," 14","Leamington",6,56,30,106,2,200,324
"Chatham-Kent--Essex/Chatham-Kent--Essex"," 15","Leamington",6,52,40,73,0,171,352
"Chatham-Kent--Essex/Chatham-Kent--Essex"," 16","Leamington",9,80,59,99,5,252,456
"Chatham-Kent--Essex/Chatham-Kent--Essex"," 17","Leamington",7,56,46,69,1,179,341
"Chatham-Kent--Essex/Chatham-Kent--Essex"," 18","Leamington",5,36,27,61,0,129,286
"Chatham-Kent--Essex/Chatham-Kent--Essex"," 19","Leamington",3,43,35,43,3,127,326
"Chatham-Kent--Essex/Chatham-Kent--Essex"," 20","Leamington",5,36,39,54,2,136,280
"Chatham-Kent--Essex/Chatham-Kent--Essex"," 21","Leamington",3,35,38,59,1,136,341
"Chatham-Kent--Essex/Chatham-Kent--Essex"," 22","Leamington",4,26,28,29,1,88,304
"Chatham-Kent--Essex/Chatham-Kent--Essex"," 23","Leamington",5,57,49,56,3,170,386
"Chatham-Kent--Essex/Chatham-Kent--Essex"," 24","Leamington",12,74,43,82,2,213,426
"Chatham-Kent--Essex/Chatham-Kent--Essex"," 25","Leamington",9,76,31,92,1,209,376
"Chatham-Kent--Essex/Chatham-Kent--Essex"," 26","Leamington",10,84,36,84,3,217,366
"Chatham-Kent--Essex/Chatham-Kent--Essex"," 27","Leamington",9,31,33,47,4,124,310
"Chatham-Kent--Essex/Chatham-Kent--Essex"," 28","Leamington",6,56,57,54,1,174,428
"Chatham-Kent--Essex/Chatham-Kent--Essex"," 29","Leamington",3,62,22,45,1,133,262
"Chatham-Kent--Essex/Chatham-Kent--Essex"," 30","Leamington",6,37,22,48,0,113,323
"Chatham-Kent--Essex/Chatham-Kent--Essex"," 31","Leamington",7,71,49,110,1,238,418
"Chatham-Kent--Essex/Chatham-Kent--Essex"," 32","Leamington",11,52,35,72,1,171,343
"Chatham-Kent--Essex/Chatham-Kent--Essex"," 33","Leamington",10,62,61,142,5,280,449
"Chatham-Kent--Essex/Chatham-Kent--Essex"," 34","Leamington",6,72,17,101,2,198,349
"Chatham-Kent--Essex/Chatham-Kent--Essex"," 35","Leamington",8,88,53,85,3,237,459
"Chatham-Kent--Essex/Chatham-Kent--Essex"," 36","Leamington",6,67,35,63,4,175,339
"Chatham-Kent--Essex/Chatham-Kent--Essex"," 37","Leamington",9,91,74,114,3,291,577
"Chatham-Kent--Essex/Chatham-Kent--Essex"," 38","Leamington",5,43,38,49,0,135,342
"Chatham-Kent--Essex/Chatham-Kent--Essex"," 39","Leamington",7,63,68,124,0,262,518
"Chatham-Kent--Essex/Chatham-Kent--Essex"," 40","Leamington",3,71,52,89,1,216,393
"Chatham-Kent--Essex/Chatham-Kent--Essex"," 41","Leamington",4,32,41,89,0,166,362
"Chatham-Kent--Essex/Chatham-Kent--Essex"," 42","Leamington",8,61,28,63,1,161,272
"Chatham-Kent--Essex/Chatham-Kent--Essex"," 43","Leamington",11,68,38,77,1,195,330
"Chatham-Kent--Essex/Chatham-Kent--Essex"," 44","Leamington",9,64,40,94,3,210,388
"Chatham-Kent--Essex/Chatham-Kent--Essex"," 45","Leamington",15,52,68,127,0,262,455
"Chatham-Kent--Essex/Chatham-Kent--Essex"," 46","Leamington",10,42,42,93,0,187,355
"Chatham-Kent--Essex/Chatham-Kent--Essex"," 47","Leamington",5,43,32,124,0,204,358
"Chatham-Kent--Essex/Chatham-Kent--Essex"," 48","Tilbury",5,40,43,62,2,152,264
"Chatham-Kent--Essex/Chatham-Kent--Essex"," 49","Tilbury",2,47,53,46,1,149,291
"Chatham-Kent--Essex/Chatham-Kent--Essex"," 50","Tilbury",3,43,56,38,0,140,260
"Chatham-Kent--Essex/Chatham-Kent--Essex"," 51","Tilbury",3,39,61,55,1,159,336
"Chatham-Kent--Essex/Chatham-Kent--Essex"," 52","Tilbury",6,60,64,46,2,178,342
"Chatham-Kent--Essex/Chatham-Kent--Essex"," 53","Tilbury",4,59,59,54,2,178,346
"Chatham-Kent--Essex/Chatham-Kent--Essex"," 54","Tilbury",5,29,39,30,0,103,179
"Chatham-Kent--Essex/Chatham-Kent--Essex"," 55","Tilbury",6,44,62,38,0,150,325
"Chatham-Kent--Essex/Chatham-Kent--Essex"," 56","Tilbury",7,10,35,39,0,91,194
"Chatham-Kent--Essex/Chatham-Kent--Essex"," 57","Tilbury",8,94,82,75,1,260,472
"Chatham-Kent--Essex/Chatham-Kent--Essex"," 58","Tilbury",2,58,55,86,0,201,323
"Chatham-Kent--Essex/Chatham-Kent--Essex"," 59","Tilbury",6,63,43,61,0,173,288
"Chatham-Kent--Essex/Chatham-Kent--Essex"," 60","Tilbury",7,27,35,85,0,154,290
"Chatham-Kent--Essex/Chatham-Kent--Essex"," 61","Merlin",4,33,53,61,1,152,263
"Chatham-Kent--Essex/Chatham-Kent--Essex"," 62","Tilbury",1,22,38,65,0,126,228
"Chatham-Kent--Essex/Chatham-Kent--Essex"," 63","Tilbury",0,16,26,62,0,104,189
"Chatham-Kent--Essex/Chatham-Kent--Essex"," 64","Merlin",4,30,69,69,0,172,271
"Chatham-Kent--Essex/Chatham-Kent--Essex"," 65","Wheatley",10,40,60,119,0,229,430
"Chatham-Kent--Essex/Chatham-Kent--Essex"," 66","Wheatley",20,63,67,96,0,246,509
"Chatham-Kent--Essex/Chatham-Kent--Essex"," 67","Wheatley",7,58,44,109,4,222,404
"Chatham-Kent--Essex/Chatham-Kent--Essex"," 68","Wheatley",4,30,49,108,0,191,369
"Chatham-Kent--Essex/Chatham-Kent--Essex"," 69","Wheatley",4,46,57,83,0,190,414
"Chatham-Kent--Essex/Chatham-Kent--Essex"," 70","Wheatley",14,69,73,161,1,318,639
"Chatham-Kent--Essex/Chatham-Kent--Essex"," 71","Chatham",10,73,57,142,1,283,446
"Chatham-Kent--Essex/Chatham-Kent--Essex"," 72","Chatham",8,54,31,60,0,153,249
"Chatham-Kent--Essex/Chatham-Kent--Essex"," 73","Chatham",7,97,45,107,2,258,465
"Chatham-Kent--Essex/Chatham-Kent--Essex"," 74","Merlin",10,71,57,96,0,234,379
"Chatham-Kent--Essex/Chatham-Kent--Essex"," 75","North Buxton",7,58,42,80,1,188,285
"Chatham-Kent--Essex/Chatham-Kent--Essex"," 76","Charing Cross",9,68,69,131,1,278,432
"Chatham-Kent--Essex/Chatham-Kent--Essex"," 77","Merlin",5,50,75,120,2,252,446
"Chatham-Kent--Essex/Chatham-Kent--Essex"," 78","Merlin",5,58,63,110,0,236,632
"Chatham-Kent--Essex/Chatham-Kent--Essex"," 79","Cedar Springs",6,72,48,122,0,248,378
"Chatham-Kent--Essex/Chatham-Kent--Essex"," 80","Chatham",2,101,32,117,1,253,384
"Chatham-Kent--Essex/Chatham-Kent--Essex"," 81","Chatham",1,54,34,53,0,142,243
"Chatham-Kent--Essex/Chatham-Kent--Essex"," 82","Chatham",8,102,41,84,1,236,413
"Chatham-Kent--Essex/Chatham-Kent--Essex"," 83","Chatham",2,78,49,52,0,181,272
"Chatham-Kent--Essex/Chatham-Kent--Essex"," 84","Chatham",10,104,56,101,1,272,424
"Chatham-Kent--Essex/Chatham-Kent--Essex"," 85","Chatham",11,86,35,86,1,219,355
"Chatham-Kent--Essex/Chatham-Kent--Essex"," 86","Chatham",3,59,30,58,1,151,224
"Chatham-Kent--Essex/Chatham-Kent--Essex"," 87","Chatham",2,56,54,66,1,179,367
"Chatham-Kent--Essex/Chatham-Kent--Essex"," 88","Chatham",7,70,62,99,0,238,374
"Chatham-Kent--Essex/Chatham-Kent--Essex"," 89","Chatham",2,108,38,119,2,269,400
"Chatham-Kent--Essex/Chatham-Kent--Essex"," 90","Chatham",10,100,37,108,0,255,452
"Chatham-Kent--Essex/Chatham-Kent--Essex"," 91","Chatham",10,95,65,112,0,282,498
"Chatham-Kent--Essex/Chatham-Kent--Essex"," 92","Chatham",7,81,38,108,0,234,335
"Chatham-Kent--Essex/Chatham-Kent--Essex"," 93","Chatham",7,76,62,63,2,210,376
"Chatham-Kent--Essex/Chatham-Kent--Essex"," 94","Chatham",1,39,39,46,1,126,259
"Chatham-Kent--Essex/Chatham-Kent--Essex"," 95","Chatham",4,136,45,141,2,328,545
"Chatham-Kent--Essex/Chatham-Kent--Essex"," 96","Chatham",6,67,34,69,1,177,331
"Chatham-Kent--Essex/Chatham-Kent--Essex"," 97","Chatham",4,95,51,94,0,244,408
"Chatham-Kent--Essex/Chatham-Kent--Essex"," 98","Chatham",4,35,39,71,1,150,321
"Chatham-Kent--Essex/Chatham-Kent--Essex"," 99","Chatham",7,116,63,122,2,310,480
"Chatham-Kent--Essex/Chatham-Kent--Essex"," 100","Chatham",8,77,70,122,1,278,502
"Chatham-Kent--Essex/Chatham-Kent--Essex"," 101","Chatham",11,65,44,73,1,194,311
"Chatham-Kent--Essex/Chatham-Kent--Essex"," 102","Chatham",5,57,49,91,1,203,325
"Chatham-Kent--Essex/Chatham-Kent--Essex"," 103","Chatham",8,40,52,57,0,157,320
"Chatham-Kent--Essex/Chatham-Kent--Essex"," 104","Chatham",6,77,45,83,0,211,370
"Chatham-Kent--Essex/Chatham-Kent--Essex"," 105","Chatham",10,71,52,83,0,216,407
"Chatham-Kent--Essex/Chatham-Kent--Essex"," 106","Chatham",7,66,47,71,0,191,362
"Chatham-Kent--Essex/Chatham-Kent--Essex"," 107","Chatham",4,50,66,59,0,179,308
"Chatham-Kent--Essex/Chatham-Kent--Essex"," 108","Chatham",5,69,55,82,1,212,347
"Chatham-Kent--Essex/Chatham-Kent--Essex"," 109","Chatham",3,86,36,67,0,192,288
"Chatham-Kent--Essex/Chatham-Kent--Essex"," 110","Chatham",4,74,56,86,3,223,343
"Chatham-Kent--Essex/Chatham-Kent--Essex"," 111","Chatham",8,65,61,64,0,198,348
"Chatham-Kent--Essex/Chatham-Kent--Essex"," 112","Chatham",10,103,79,89,0,281,438
"Chatham-Kent--Essex/Chatham-Kent--Essex"," 113","Chatham",11,94,52,100,0,257,460
"Chatham-Kent--Essex/Chatham-Kent--Essex"," 114","Chatham",15,114,62,75,1,267,392
"Chatham-Kent--Essex/Chatham-Kent--Essex"," 115","Chatham",4,32,23,42,1,102,240
"Chatham-Kent--Essex/Chatham-Kent--Essex"," 116","Chatham",3,63,19,67,0,152,192
"Chatham-Kent--Essex/Chatham-Kent--Essex"," 117","Chatham",12,97,51,76,2,238,359
"Chatham-Kent--Essex/Chatham-Kent--Essex"," 118","Chatham",6,53,53,48,0,160,341
"Chatham-Kent--Essex/Chatham-Kent--Essex"," 119","Chatham",8,75,70,54,1,208,376
"Chatham-Kent--Essex/Chatham-Kent--Essex"," 120","Chatham",4,27,24,37,1,93,192
"Chatham-Kent--Essex/Chatham-Kent--Essex"," 121","Chatham",4,66,52,57,0,179,334
"Chatham-Kent--Essex/Chatham-Kent--Essex"," 122","Chatham",11,71,36,72,0,190,382
"Chatham-Kent--Essex/Chatham-Kent--Essex"," 123","Chatham",5,68,39,65,0,177,336
"Chatham-Kent--Essex/Chatham-Kent--Essex"," 124","Chatham",11,68,50,60,0,189,381
"Chatham-Kent--Essex/Chatham-Kent--Essex"," 125","Chatham",7,71,63,99,0,240,334
"Chatham-Kent--Essex/Chatham-Kent--Essex"," 126","Chatham",4,59,59,85,1,208,291
"Chatham-Kent--Essex/Chatham-Kent--Essex"," 127","Chatham",10,46,51,72,1,180,388
"Chatham-Kent--Essex/Chatham-Kent--Essex"," 128","Chatham",12,60,50,54,2,178,349
"Chatham-Kent--Essex/Chatham-Kent--Essex"," 129","Chatham",5,30,47,36,1,119,271
"Chatham-Kent--Essex/Chatham-Kent--Essex"," 130","Chatham",6,74,58,98,1,237,383
"Chatham-Kent--Essex/Chatham-Kent--Essex"," 131","Chatham",5,63,48,61,1,178,400
"Chatham-Kent--Essex/Chatham-Kent--Essex"," 132","Chatham",6,66,20,40,1,133,217
"Chatham-Kent--Essex/Chatham-Kent--Essex"," 133","Chatham",6,103,55,75,0,239,379
"Chatham-Kent--Essex/Chatham-Kent--Essex"," 134","Chatham",4,63,46,82,0,195,341
"Chatham-Kent--Essex/Chatham-Kent--Essex"," 135","Chatham",4,52,48,43,0,147,336
"Chatham-Kent--Essex/Chatham-Kent--Essex"," 136","Chatham",11,79,36,76,0,202,325
"Chatham-Kent--Essex/Chatham-Kent--Essex"," 137","Chatham",7,60,60,36,2,165,286
"Chatham-Kent--Essex/Chatham-Kent--Essex"," 138","Chatham",2,52,40,22,0,116,250
"Chatham-Kent--Essex/Chatham-Kent--Essex"," 139","Chatham",8,57,67,43,0,175,369
"Chatham-Kent--Essex/Chatham-Kent--Essex"," 140","Chatham",5,33,58,51,0,147,341
"Chatham-Kent--Essex/Chatham-Kent--Essex"," 141","Chatham",2,40,63,50,4,159,305
"Chatham-Kent--Essex/Chatham-Kent--Essex"," 142","Chatham",2,13,25,34,0,74,155
"Chatham-Kent--Essex/Chatham-Kent--Essex"," 143","Chatham",3,41,41,49,0,134,346
"Chatham-Kent--Essex/Chatham-Kent--Essex"," 144","Chatham",4,30,41,25,2,102,277
"Chatham-Kent--Essex/Chatham-Kent--Essex"," 145","Chatham",6,45,52,66,3,172,391
"Chatham-Kent--Essex/Chatham-Kent--Essex"," 146","Chatham",2,20,37,60,1,120,223
"Chatham-Kent--Essex/Chatham-Kent--Essex"," 147","Chatham",7,68,67,83,1,226,402
"Chatham-Kent--Essex/Chatham-Kent--Essex"," 148","Chatham",6,52,54,73,0,185,344
"Chatham-Kent--Essex/Chatham-Kent--Essex"," 149","Chatham",4,46,17,86,0,153,229
"Chatham-Kent--Essex/Chatham-Kent--Essex"," 150","Chatham",5,95,41,85,1,227,419
"Chatham-Kent--Essex/Chatham-Kent--Essex"," 151","Chatham",7,48,36,50,0,141,302
"Chatham-Kent--Essex/Chatham-Kent--Essex"," 152","Chatham",11,71,37,108,0,227,366
"Chatham-Kent--Essex/Chatham-Kent--Essex"," 153","Chatham",6,48,56,64,1,175,397
"Chatham-Kent--Essex/Chatham-Kent--Essex"," 154","Chatham",10,31,55,35,0,131,287
"Chatham-Kent--Essex/Chatham-Kent--Essex"," 155","Chatham",7,95,28,76,0,206,357
"Chatham-Kent--Essex/Chatham-Kent--Essex"," 156","Chatham",7,49,65,107,5,233,402
"Chatham-Kent--Essex/Chatham-Kent--Essex"," 157","Chatham",7,68,66,50,0,191,309
"Chatham-Kent--Essex/Chatham-Kent--Essex"," 158","Chatham",8,76,36,114,1,235,373
"Chatham-Kent--Essex/Chatham-Kent--Essex"," 159","Chatham",5,101,14,92,2,214,345
"Chatham-Kent--Essex/Chatham-Kent--Essex"," 160","Chatham",7,55,88,137,0,287,529
"Chatham-Kent--Essex/Chatham-Kent--Essex"," 161","Chatham",9,52,66,63,0,190,378
"Chatham-Kent--Essex/Chatham-Kent--Essex"," 162","Chatham",6,73,62,103,0,244,363
"Chatham-Kent--Essex/Chatham-Kent--Essex"," 163","Chatham",7,78,35,83,1,204,334
"Chatham-Kent--Essex/Chatham-Kent--Essex"," 164","Chatham",7,93,44,101,0,245,388
"Chatham-Kent--Essex/Chatham-Kent--Essex"," 165","Chatham",7,45,57,82,0,191,311
"Chatham-Kent--Essex/Chatham-Kent--Essex"," 166","Chatham",9,67,30,102,5,213,348
"Chatham-Kent--Essex/Chatham-Kent--Essex"," 167","Chatham",1,39,56,45,0,141,308
"Chatham-Kent--Essex/Chatham-Kent--Essex"," 168","Chatham",2,92,63,149,0,306,490
"Chatham-Kent--Essex/Chatham-Kent--Essex"," 169","Chatham",6,53,33,101,0,193,316
"Chatham-Kent--Essex/Chatham-Kent--Essex"," 170","Chatham",5,73,28,128,0,234,417
"Chatham-Kent--Essex/Chatham-Kent--Essex"," 171","Chatham",6,56,16,50,0,128,235
"Chatham-Kent--Essex/Chatham-Kent--Essex"," 172","Chatham",11,70,43,120,0,244,413
"Chatham-Kent--Essex/Chatham-Kent--Essex"," 173","Charing Cross",4,29,26,64,0,123,239
"Chatham-Kent--Essex/Chatham-Kent--Essex"," 174","Blenheim",5,39,35,119,1,199,363
"Chatham-Kent--Essex/Chatham-Kent--Essex"," 175","Cedar Springs",2,68,35,71,0,176,305
"Chatham-Kent--Essex/Chatham-Kent--Essex"," 176","Blenheim",10,91,61,88,2,252,464
"Chatham-Kent--Essex/Chatham-Kent--Essex"," 177","Blenheim",9,49,36,71,0,165,373
"Chatham-Kent--Essex/Chatham-Kent--Essex"," 178","Blenheim",6,69,62,110,1,248,410
"Chatham-Kent--Essex/Chatham-Kent--Essex"," 179","Blenheim",16,72,64,68,0,220,384
"Chatham-Kent--Essex/Chatham-Kent--Essex"," 180","Blenheim",9,39,38,53,0,139,256
"Chatham-Kent--Essex/Chatham-Kent--Essex"," 181","Blenheim",10,59,70,94,0,233,441
"Chatham-Kent--Essex/Chatham-Kent--Essex"," 182","Blenheim",9,46,66,39,0,160,285
"Chatham-Kent--Essex/Chatham-Kent--Essex"," 183","Blenheim",3,50,41,86,1,181,296
"Chatham-Kent--Essex/Chatham-Kent--Essex"," 184","Blenheim",8,105,71,110,0,294,486
"Chatham-Kent--Essex/Chatham-Kent--Essex"," 185","Blenheim",29,45,29,123,1,227,332
"Chatham-Kent--Essex/Chatham-Kent--Essex"," 186","Blenheim",6,53,79,97,0,235,449
"Chatham-Kent--Essex/Chatham-Kent--Essex"," 187","Blenheim",9,52,38,73,0,172,354
"Chatham-Kent--Essex/Chatham-Kent--Essex"," 188","Cedar Springs",17,43,38,85,0,183,321
"Chatham-Kent--Essex/Chatham-Kent--Essex"," 189","Cedar Springs",5,26,39,26,0,96,163
"Chatham-Kent--Essex/Chatham-Kent--Essex"," 190","Erieau",19,78,43,85,1,226,360
"Chatham-Kent--Essex/Chatham-Kent--Essex"," 191","Morpeth",5,58,32,127,1,223,413
"Chatham-Kent--Essex/Chatham-Kent--Essex"," 192","Kent Bridge",10,63,34,90,0,197,329
"Chatham-Kent--Essex/Chatham-Kent--Essex"," 193","Kent Bridge",7,65,44,94,0,210,338
"Chatham-Kent--Essex/Chatham-Kent--Essex"," 194","Ridgetown",14,45,36,78,1,174,275
"Chatham-Kent--Essex/Chatham-Kent--Essex"," 195","Ridgetown",7,66,58,62,0,193,345
"Chatham-Kent--Essex/Chatham-Kent--Essex"," 196","Ridgetown",8,58,48,84,0,198,353
"Chatham-Kent--Essex/Chatham-Kent--Essex"," 197","Ridgetown",6,47,41,51,4,149,299
"Chatham-Kent--Essex/Chatham-Kent--Essex"," 198","Ridgetown",10,51,45,76,2,184,369
"Chatham-Kent--Essex/Chatham-Kent--Essex"," 199","Ridgetown",8,75,53,95,0,231,387
"Chatham-Kent--Essex/Chatham-Kent--Essex"," 200","Ridgetown",7,62,37,74,3,183,311
"Chatham-Kent--Essex/Chatham-Kent--Essex"," 201","Ridgetown",6,75,41,62,1,185,303
"Chatham-Kent--Essex/Chatham-Kent--Essex"," 202","Morpeth",3,62,34,107,2,208,342
"Chatham-Kent--Essex/Chatham-Kent--Essex"," 203","Morpeth",10,32,67,63,0,172,276
"Chatham-Kent--Essex/Chatham-Kent--Essex"," 204","Moraviantown",28,32,49,11,0,120,171
"Chatham-Kent--Essex/Chatham-Kent--Essex"," 205","Highgate",9,58,49,103,0,219,335
"Chatham-Kent--Essex/Chatham-Kent--Essex"," 206","Highgate",9,48,53,67,2,179,275
"Chatham-Kent--Essex/Chatham-Kent--Essex"," 207","Highgate",12,43,28,74,0,157,229
"Chatham-Kent--Essex/Chatham-Kent--Essex"," 208","Highgate",13,57,41,85,1,197,312
"Chatham-Kent--Essex/Chatham-Kent--Essex"," 400","Leamington",1,28,24,20,3,76,206
"Chatham-Kent--Essex/Chatham-Kent--Essex"," 401","Chatham",3,67,11,52,2,135,190
"Chatham-Kent--Essex/Chatham-Kent--Essex"," 402","Chatham",0,30,5,17,1,53,149
"Chatham-Kent--Essex/Chatham-Kent--Essex"," 403","Chatham",1,46,16,26,1,90,323
"Chatham-Kent--Essex/Chatham-Kent--Essex"," 500","Mobile poll/Bureau itinérant",6,39,14,50,3,112,148
"Chatham-Kent--Essex/Chatham-Kent--Essex"," 501","Mobile poll/Bureau itinérant",2,38,9,24,3,76,150
"Chatham-Kent--Essex/Chatham-Kent--Essex"," 502","Mobile poll/Bureau itinérant",2,7,3,10,1,23,120
"Chatham-Kent--Essex/Chatham-Kent--Essex"," 503","Mobile poll/Bureau itinérant",3,33,7,6,0,49,93
"Chatham-Kent--Essex/Chatham-Kent--Essex"," 504A","Chatham",5,29,7,15,1,57,75
"Chatham-Kent--Essex/Chatham-Kent--Essex"," 504B","Mobile poll/Bureau itinérant",4,27,8,25,0,64,78
"Chatham-Kent--Essex/Chatham-Kent--Essex"," 505","Mobile poll/Bureau itinérant",4,47,6,38,1,96,132
"Chatham-Kent--Essex/Chatham-Kent--Essex"," 506","Mobile poll/Bureau itinérant",3,18,5,16,1,43,89
"Chatham-Kent--Essex/Chatham-Kent--Essex"," 507","Mobile poll/Bureau itinérant",1,45,10,17,2,75,104
"Chatham-Kent--Essex/Chatham-Kent--Essex"," 600","Leamington",13,149,49,272,2,485,
"Chatham-Kent--Essex/Chatham-Kent--Essex"," 601","Leamington",23,198,108,364,6,699,
"Chatham-Kent--Essex/Chatham-Kent--Essex"," 602","Wheatley",9,57,35,161,0,262,
"Chatham-Kent--Essex/Chatham-Kent--Essex"," 603","Tilbury",7,160,115,195,3,480,
"Chatham-Kent--Essex/Chatham-Kent--Essex"," 604","Raleigh",8,93,63,224,0,388,
"Chatham-Kent--Essex/Chatham-Kent--Essex"," 605","Chatham",17,143,70,285,0,515,
"Chatham-Kent--Essex/Chatham-Kent--Essex"," 606","Chatham",18,205,122,361,1,707,
"Chatham-Kent--Essex/Chatham-Kent--Essex"," 607","Chatham",12,102,55,168,2,339,
"Chatham-Kent--Essex/Chatham-Kent--Essex"," 608","Chatham",14,199,131,407,1,752,
"Chatham-Kent--Essex/Chatham-Kent--Essex"," 609","Blenheim",29,215,107,343,1,695,
"Chatham-Kent--Essex/Chatham-Kent--Essex"," 610","Ridgetown",18,131,86,257,0,492,
"Chatham-Kent--Essex/Chatham-Kent--Essex",,Group 1/Groupe 1,4,26,10,33,2,75,161
"Chatham-Kent--Essex/Chatham-Kent--Essex",,Group 2/Groupe 2,58,581,172,863,15,1689,
