Electoral District/Circonscription,Polling Station Number/Numéro du bureau de scrutin,Polling Station Name/Nom du bureau de scrutin,Trey Capnerhurst,Arlene Chapman,Peter Goldring,Nicole Martel,Rejected Ballots/Bulletins rejetés,Total Votes/Total des votes,Electors/Électeurs
"Edmonton East/Edmonton-Est"," 1A","Edmonton",8,29,122,63,0,222,483
"Edmonton East/Edmonton-Est"," 1B","Edmonton",7,36,91,42,0,176,391
"Edmonton East/Edmonton-Est"," 2A","Edmonton",5,28,112,61,0,206,447
"Edmonton East/Edmonton-Est"," 2B","Edmonton",3,17,117,67,0,204,463
"Edmonton East/Edmonton-Est"," 3A","Edmonton",7,16,94,94,0,211,449
"Edmonton East/Edmonton-Est"," 3B","Edmonton",2,17,85,88,0,192,396
"Edmonton East/Edmonton-Est"," 3-1A","Edmonton",13,19,108,51,0,191,374
"Edmonton East/Edmonton-Est"," 3-1B","Edmonton",3,15,91,48,3,160,393
"Edmonton East/Edmonton-Est"," 4","Edmonton",11,22,100,100,0,233,520
"Edmonton East/Edmonton-Est"," 5","Edmonton",17,51,133,58,0,259,512
"Edmonton East/Edmonton-Est"," 6","Edmonton",4,29,108,60,1,202,405
"Edmonton East/Edmonton-Est"," 7","Edmonton",6,21,85,53,0,165,269
"Edmonton East/Edmonton-Est"," 8","Edmonton",3,36,104,52,1,196,389
"Edmonton East/Edmonton-Est"," 9","Edmonton",3,20,97,51,2,173,322
"Edmonton East/Edmonton-Est"," 10","Edmonton",2,33,83,65,1,184,359
"Edmonton East/Edmonton-Est"," 11","Edmonton",12,28,136,80,1,257,402
"Edmonton East/Edmonton-Est"," 12","Edmonton",6,20,34,50,2,112,440
"Edmonton East/Edmonton-Est"," 13","Edmonton",5,12,40,43,0,100,278
"Edmonton East/Edmonton-Est"," 14","Edmonton",9,20,112,61,3,205,374
"Edmonton East/Edmonton-Est"," 15","Edmonton",9,28,72,84,1,194,396
"Edmonton East/Edmonton-Est"," 16","Edmonton",10,24,100,75,0,209,417
"Edmonton East/Edmonton-Est"," 17","Edmonton",8,26,48,44,0,126,372
"Edmonton East/Edmonton-Est"," 18","Edmonton",3,22,49,37,2,113,282
"Edmonton East/Edmonton-Est"," 19","Edmonton",3,28,104,70,0,205,360
"Edmonton East/Edmonton-Est"," 20","Edmonton",1,26,65,18,0,110,262
"Edmonton East/Edmonton-Est"," 21","Edmonton",21,21,114,36,0,192,374
"Edmonton East/Edmonton-Est"," 22","Edmonton",8,26,76,50,1,161,352
"Edmonton East/Edmonton-Est"," 23A","Edmonton",8,21,113,106,1,249,531
"Edmonton East/Edmonton-Est"," 23B","Edmonton",7,20,110,73,0,210,466
"Edmonton East/Edmonton-Est"," 24","Edmonton",6,24,100,95,1,226,478
"Edmonton East/Edmonton-Est"," 25","Edmonton",4,15,108,83,0,210,446
"Edmonton East/Edmonton-Est"," 26A","Edmonton",0,21,64,50,0,135,345
"Edmonton East/Edmonton-Est"," 26B","Edmonton",3,11,79,72,1,166,334
"Edmonton East/Edmonton-Est"," 27A","Edmonton",7,15,91,51,0,164,350
"Edmonton East/Edmonton-Est"," 27B","Edmonton",5,19,84,56,0,164,343
"Edmonton East/Edmonton-Est"," 28A","Edmonton",7,19,104,79,0,209,409
"Edmonton East/Edmonton-Est"," 28B","Edmonton",6,22,102,77,1,208,403
"Edmonton East/Edmonton-Est"," 29","Edmonton",7,19,87,55,2,170,348
"Edmonton East/Edmonton-Est"," 30","Edmonton",3,18,130,73,0,224,510
"Edmonton East/Edmonton-Est"," 31A","Edmonton",11,16,75,55,0,157,309
"Edmonton East/Edmonton-Est"," 31B","Edmonton",5,16,76,43,1,141,331
"Edmonton East/Edmonton-Est"," 32","Edmonton",12,39,127,78,0,256,427
"Edmonton East/Edmonton-Est"," 33","Edmonton",11,45,155,97,2,310,539
"Edmonton East/Edmonton-Est"," 34","Edmonton",8,37,124,30,0,199,299
"Edmonton East/Edmonton-Est"," 35","Edmonton",11,36,91,63,0,201,289
"Edmonton East/Edmonton-Est"," 36","Edmonton",9,32,102,61,0,204,365
"Edmonton East/Edmonton-Est"," 37","Edmonton",8,23,79,54,0,164,277
"Edmonton East/Edmonton-Est"," 38","Edmonton",9,32,156,64,1,262,408
"Edmonton East/Edmonton-Est"," 39","Edmonton",12,32,67,38,0,149,338
"Edmonton East/Edmonton-Est"," 40","Edmonton",10,33,79,56,0,178,359
"Edmonton East/Edmonton-Est"," 41","Edmonton",7,21,59,38,0,125,375
"Edmonton East/Edmonton-Est"," 42","Edmonton",6,27,72,62,0,167,316
"Edmonton East/Edmonton-Est"," 43","Edmonton",5,31,69,42,2,149,480
"Edmonton East/Edmonton-Est"," 44","Edmonton",11,22,114,53,0,200,388
"Edmonton East/Edmonton-Est"," 45","Edmonton",10,35,95,55,2,197,354
"Edmonton East/Edmonton-Est"," 46","Edmonton",11,40,105,60,0,216,368
"Edmonton East/Edmonton-Est"," 47","Edmonton",Merged with No. 48/Fusionné avec le nº 48,,,,,,137
"Edmonton East/Edmonton-Est"," 48","Edmonton",10,30,190,57,0,287,327
"Edmonton East/Edmonton-Est"," 49A","Edmonton",14,37,147,60,0,258,476
"Edmonton East/Edmonton-Est"," 49B","Edmonton",10,28,146,63,1,248,433
"Edmonton East/Edmonton-Est"," 50A","Edmonton",5,32,90,68,0,195,434
"Edmonton East/Edmonton-Est"," 50B","Edmonton",6,20,104,55,0,185,391
"Edmonton East/Edmonton-Est"," 51A","Edmonton",8,27,109,68,0,212,421
"Edmonton East/Edmonton-Est"," 51B","Edmonton",7,25,88,33,0,153,294
"Edmonton East/Edmonton-Est"," 52","Edmonton",4,18,82,40,0,144,280
"Edmonton East/Edmonton-Est"," 53","Edmonton",10,21,134,66,0,231,473
"Edmonton East/Edmonton-Est"," 54","Edmonton",9,23,102,85,0,219,416
"Edmonton East/Edmonton-Est"," 55","Edmonton",10,22,144,47,0,223,406
"Edmonton East/Edmonton-Est"," 56","Edmonton",8,13,115,51,0,187,346
"Edmonton East/Edmonton-Est"," 57","Edmonton",8,23,80,28,1,140,264
"Edmonton East/Edmonton-Est"," 58","Edmonton",1,24,84,46,0,155,260
"Edmonton East/Edmonton-Est"," 59","Edmonton",4,15,109,55,1,184,364
"Edmonton East/Edmonton-Est"," 60","Edmonton",5,47,180,57,0,289,537
"Edmonton East/Edmonton-Est"," 61","Edmonton",11,33,102,46,1,193,416
"Edmonton East/Edmonton-Est"," 62A","Edmonton",11,20,71,16,0,118,314
"Edmonton East/Edmonton-Est"," 62B","Edmonton",4,22,78,44,0,148,312
"Edmonton East/Edmonton-Est"," 63","Edmonton",12,27,125,64,0,228,411
"Edmonton East/Edmonton-Est"," 64","Edmonton",7,39,142,58,0,246,394
"Edmonton East/Edmonton-Est"," 65","Edmonton",11,31,85,42,0,169,471
"Edmonton East/Edmonton-Est"," 66","Edmonton",4,17,59,36,0,116,260
"Edmonton East/Edmonton-Est"," 67","Edmonton",18,30,108,61,0,217,474
"Edmonton East/Edmonton-Est"," 68A","Edmonton",5,42,144,63,0,254,500
"Edmonton East/Edmonton-Est"," 68B","Mobile poll/Bureau itinérant",Merged with No. 79B/Fusionné avec le nº 79B,,,,,,56
"Edmonton East/Edmonton-Est"," 68C","Edmonton",9,49,121,69,0,248,500
"Edmonton East/Edmonton-Est"," 68D","Edmonton",17,57,127,56,1,258,478
"Edmonton East/Edmonton-Est"," 68-1","Edmonton",6,41,123,50,0,220,461
"Edmonton East/Edmonton-Est"," 69","Edmonton",9,23,113,44,1,190,355
"Edmonton East/Edmonton-Est"," 70","Edmonton",10,32,133,33,0,208,358
"Edmonton East/Edmonton-Est"," 71","Edmonton",14,26,85,33,1,159,310
"Edmonton East/Edmonton-Est"," 72","Edmonton",11,62,141,45,0,259,569
"Edmonton East/Edmonton-Est"," 73","Edmonton",13,19,64,43,1,140,369
"Edmonton East/Edmonton-Est"," 74","Edmonton",4,49,99,39,0,191,470
"Edmonton East/Edmonton-Est"," 75","Edmonton",8,35,130,40,0,213,364
"Edmonton East/Edmonton-Est"," 76","Edmonton",13,44,144,50,0,251,460
"Edmonton East/Edmonton-Est"," 77","Edmonton",12,38,113,70,0,233,413
"Edmonton East/Edmonton-Est"," 78","Edmonton",9,18,132,83,0,242,389
"Edmonton East/Edmonton-Est"," 79A","Edmonton",3,19,69,28,0,119,252
"Edmonton East/Edmonton-Est"," 79B","Mobile poll/Bureau itinérant",1,14,51,18,1,85,54
"Edmonton East/Edmonton-Est"," 80","Edmonton",4,26,127,63,0,220,393
"Edmonton East/Edmonton-Est"," 81","Edmonton",13,59,118,77,0,267,455
"Edmonton East/Edmonton-Est"," 82","Edmonton",10,34,144,60,0,248,446
"Edmonton East/Edmonton-Est"," 83","Edmonton",6,23,100,31,0,160,378
"Edmonton East/Edmonton-Est"," 84","Edmonton",1,22,87,32,0,142,331
"Edmonton East/Edmonton-Est"," 85","Edmonton",7,21,43,24,0,95,225
"Edmonton East/Edmonton-Est"," 86","Edmonton",11,24,70,63,2,170,319
"Edmonton East/Edmonton-Est"," 87","Edmonton",10,34,101,38,0,183,323
"Edmonton East/Edmonton-Est"," 88","Edmonton",6,20,48,23,0,97,329
"Edmonton East/Edmonton-Est"," 89","Edmonton",6,31,64,31,0,132,327
"Edmonton East/Edmonton-Est"," 90","Edmonton",4,32,70,35,0,141,289
"Edmonton East/Edmonton-Est"," 91","Edmonton",11,39,102,34,1,187,405
"Edmonton East/Edmonton-Est"," 92","Edmonton",6,39,84,44,0,173,403
"Edmonton East/Edmonton-Est"," 93","Edmonton",6,38,104,43,0,191,418
"Edmonton East/Edmonton-Est"," 94","Edmonton",7,22,76,30,0,135,399
"Edmonton East/Edmonton-Est"," 95","Edmonton",5,33,86,48,0,172,352
"Edmonton East/Edmonton-Est"," 96","Edmonton",4,34,126,58,0,222,457
"Edmonton East/Edmonton-Est"," 97","Edmonton",11,30,98,43,0,182,409
"Edmonton East/Edmonton-Est"," 98","Edmonton",10,39,71,30,0,150,385
"Edmonton East/Edmonton-Est"," 99","Edmonton",6,31,91,49,0,177,342
"Edmonton East/Edmonton-Est"," 100","Edmonton",9,27,114,46,0,196,311
"Edmonton East/Edmonton-Est"," 101","Edmonton",13,28,114,55,0,210,341
"Edmonton East/Edmonton-Est"," 102","Edmonton",13,39,90,37,1,180,316
"Edmonton East/Edmonton-Est"," 103","Edmonton",10,15,58,37,0,120,219
"Edmonton East/Edmonton-Est"," 104","Edmonton",9,39,142,43,0,233,424
"Edmonton East/Edmonton-Est"," 105","Edmonton",6,32,62,38,1,139,354
"Edmonton East/Edmonton-Est"," 106","Edmonton",3,24,72,47,0,146,401
"Edmonton East/Edmonton-Est"," 107","Edmonton",10,36,128,38,1,213,379
"Edmonton East/Edmonton-Est"," 108","Edmonton",7,32,89,29,0,157,347
"Edmonton East/Edmonton-Est"," 109","Edmonton",2,30,120,38,1,191,354
"Edmonton East/Edmonton-Est"," 110","Edmonton",23,44,87,42,0,196,395
"Edmonton East/Edmonton-Est"," 111","Edmonton",6,45,102,40,0,193,380
"Edmonton East/Edmonton-Est"," 112","Edmonton",12,29,84,29,1,155,385
"Edmonton East/Edmonton-Est"," 113","Edmonton",12,37,92,51,0,192,453
"Edmonton East/Edmonton-Est"," 114","Edmonton",8,31,48,18,0,105,314
"Edmonton East/Edmonton-Est"," 115A","Edmonton",5,11,38,17,0,71,207
"Edmonton East/Edmonton-Est"," 115B","Mobile poll/Bureau itinérant",6,29,55,53,1,144,90
"Edmonton East/Edmonton-Est"," 116","Edmonton",12,32,70,27,3,144,337
"Edmonton East/Edmonton-Est"," 117","Edmonton",5,42,49,31,0,127,266
"Edmonton East/Edmonton-Est"," 118","Edmonton",8,42,57,54,1,162,349
"Edmonton East/Edmonton-Est"," 119","Edmonton",8,37,76,41,0,162,376
"Edmonton East/Edmonton-Est"," 120","Edmonton",5,22,60,48,1,136,346
"Edmonton East/Edmonton-Est"," 121","Edmonton",2,15,63,44,0,124,350
"Edmonton East/Edmonton-Est"," 122","Edmonton",7,14,44,31,0,96,273
"Edmonton East/Edmonton-Est"," 123","Edmonton",6,43,60,41,1,151,243
"Edmonton East/Edmonton-Est"," 124","Edmonton",5,39,91,45,4,184,406
"Edmonton East/Edmonton-Est"," 125","Edmonton",6,38,51,43,0,138,347
"Edmonton East/Edmonton-Est"," 126","Edmonton",17,47,79,50,2,195,405
"Edmonton East/Edmonton-Est"," 127","Edmonton",8,22,43,40,0,113,333
"Edmonton East/Edmonton-Est"," 128","Edmonton",10,27,62,39,0,138,356
"Edmonton East/Edmonton-Est"," 129","Edmonton",24,50,93,50,1,218,490
"Edmonton East/Edmonton-Est"," 130","Edmonton",13,46,72,53,3,187,479
"Edmonton East/Edmonton-Est"," 131","Edmonton",12,31,49,54,0,146,415
"Edmonton East/Edmonton-Est"," 132","Edmonton",15,33,55,45,0,148,419
"Edmonton East/Edmonton-Est"," 133","Edmonton",5,17,49,35,0,106,364
"Edmonton East/Edmonton-Est"," 134","Edmonton",6,24,53,24,0,107,278
"Edmonton East/Edmonton-Est"," 135","Edmonton",10,45,76,48,0,179,469
"Edmonton East/Edmonton-Est"," 136","Edmonton",13,53,101,42,0,209,483
"Edmonton East/Edmonton-Est"," 137","Edmonton",12,42,125,53,0,232,359
"Edmonton East/Edmonton-Est"," 138","Edmonton",13,54,138,49,1,255,488
"Edmonton East/Edmonton-Est"," 139","Edmonton",9,31,93,36,0,169,295
"Edmonton East/Edmonton-Est"," 140","Edmonton",9,57,133,54,1,254,417
"Edmonton East/Edmonton-Est"," 141","Edmonton",13,41,114,38,0,206,362
"Edmonton East/Edmonton-Est"," 142","Edmonton",6,56,124,25,2,213,375
"Edmonton East/Edmonton-Est"," 143","Edmonton",6,41,54,27,0,128,320
"Edmonton East/Edmonton-Est"," 144","Edmonton",9,36,63,53,0,161,457
"Edmonton East/Edmonton-Est"," 145","Edmonton",Merged with No. 146/Fusionné avec le nº 146,,,,,,181
"Edmonton East/Edmonton-Est"," 146","Edmonton",26,73,121,59,0,279,327
"Edmonton East/Edmonton-Est"," 147","Edmonton",15,43,109,39,0,206,400
"Edmonton East/Edmonton-Est"," 148","Edmonton",12,36,65,38,1,152,280
"Edmonton East/Edmonton-Est"," 149","Edmonton",5,29,77,32,0,143,290
"Edmonton East/Edmonton-Est"," 150","Edmonton",8,33,64,26,0,131,270
"Edmonton East/Edmonton-Est"," 151","Edmonton",12,36,110,32,0,190,419
"Edmonton East/Edmonton-Est"," 152","Edmonton",11,41,112,28,0,192,388
"Edmonton East/Edmonton-Est"," 153","Edmonton",14,81,129,31,0,255,407
"Edmonton East/Edmonton-Est"," 154","Edmonton",13,49,81,30,0,173,307
"Edmonton East/Edmonton-Est"," 155","Edmonton",9,38,118,30,2,197,431
"Edmonton East/Edmonton-Est"," 156","Edmonton",16,76,118,23,0,233,394
"Edmonton East/Edmonton-Est"," 157","Edmonton",8,47,118,27,0,200,357
"Edmonton East/Edmonton-Est"," 158","Edmonton",8,44,144,28,0,224,429
"Edmonton East/Edmonton-Est"," 159","Edmonton",20,38,111,37,0,206,353
"Edmonton East/Edmonton-Est"," 160","Edmonton",11,34,66,42,0,153,403
"Edmonton East/Edmonton-Est"," 161","Edmonton",17,28,52,28,0,125,347
"Edmonton East/Edmonton-Est"," 162","Edmonton",10,65,172,60,2,309,542
"Edmonton East/Edmonton-Est"," 163","Edmonton",2,36,86,22,1,147,308
"Edmonton East/Edmonton-Est"," 164","Edmonton",6,34,95,28,2,165,300
"Edmonton East/Edmonton-Est"," 165","Edmonton",9,41,79,43,0,172,389
"Edmonton East/Edmonton-Est"," 166","Edmonton",9,33,39,39,0,120,385
"Edmonton East/Edmonton-Est"," 167","Edmonton",8,31,95,37,0,171,340
"Edmonton East/Edmonton-Est"," 168","Edmonton",10,28,84,32,0,154,365
"Edmonton East/Edmonton-Est"," 169","Edmonton",7,60,101,49,0,217,366
"Edmonton East/Edmonton-Est"," 170","Edmonton",9,49,113,44,0,215,447
"Edmonton East/Edmonton-Est"," 171","Edmonton",12,58,128,39,0,237,362
"Edmonton East/Edmonton-Est"," 172","Edmonton",13,31,138,31,0,213,375
"Edmonton East/Edmonton-Est"," 173","Edmonton",11,50,119,22,0,202,320
"Edmonton East/Edmonton-Est"," 174","Edmonton",9,36,81,35,0,161,306
"Edmonton East/Edmonton-Est"," 175","Edmonton",12,56,120,43,1,232,379
"Edmonton East/Edmonton-Est"," 176","Edmonton",12,42,56,35,2,147,364
"Edmonton East/Edmonton-Est"," 177","Edmonton",15,39,54,34,2,144,319
"Edmonton East/Edmonton-Est"," 178","Edmonton",10,44,65,51,1,171,335
"Edmonton East/Edmonton-Est"," 179","Edmonton",16,58,69,48,0,191,425
"Edmonton East/Edmonton-Est"," 180","Edmonton",18,50,69,64,2,203,425
"Edmonton East/Edmonton-Est"," 181","Edmonton",2,17,26,27,0,72,233
"Edmonton East/Edmonton-Est"," 182","Edmonton",18,49,66,43,2,178,389
"Edmonton East/Edmonton-Est"," 183A","Edmonton",14,41,70,64,2,191,435
"Edmonton East/Edmonton-Est"," 183B","Mobile poll/Bureau itinérant",Merged with No. 115B/Fusionné avec le nº 115B,,,,,,22
"Edmonton East/Edmonton-Est"," 184","Edmonton",13,57,52,48,2,172,378
"Edmonton East/Edmonton-Est"," 185","Edmonton",17,47,79,70,0,213,491
"Edmonton East/Edmonton-Est"," 186","Edmonton",15,40,64,58,1,178,408
"Edmonton East/Edmonton-Est"," 187","Edmonton",8,31,51,30,2,122,294
"Edmonton East/Edmonton-Est"," 188A","Edmonton",12,34,82,38,1,167,353
"Edmonton East/Edmonton-Est"," 188B","Edmonton",12,34,59,36,0,141,325
"Edmonton East/Edmonton-Est"," 189A","Edmonton",14,45,98,36,0,193,327
"Edmonton East/Edmonton-Est"," 189B","Edmonton",18,57,101,47,2,225,337
"Edmonton East/Edmonton-Est"," 190","Edmonton",21,40,101,38,1,201,348
"Edmonton East/Edmonton-Est"," 191","Edmonton",22,53,97,52,3,227,356
"Edmonton East/Edmonton-Est"," 192","Edmonton",34,66,81,24,1,206,336
"Edmonton East/Edmonton-Est"," 193","Edmonton",20,89,82,44,0,235,416
"Edmonton East/Edmonton-Est"," 194","Edmonton",15,64,57,30,0,166,278
"Edmonton East/Edmonton-Est"," 195","Edmonton",8,41,84,28,2,163,263
"Edmonton East/Edmonton-Est"," 196","Edmonton",17,64,128,62,1,272,422
"Edmonton East/Edmonton-Est"," 197","Edmonton",11,32,36,39,2,120,295
"Edmonton East/Edmonton-Est"," 198","Edmonton",16,52,68,62,1,199,483
"Edmonton East/Edmonton-Est"," 199","Edmonton",10,26,42,42,1,121,234
"Edmonton East/Edmonton-Est"," 200","Edmonton",12,58,38,48,1,157,322
"Edmonton East/Edmonton-Est"," 201","Edmonton",6,25,38,52,0,121,373
"Edmonton East/Edmonton-Est"," 202","Edmonton",15,44,54,99,1,213,585
"Edmonton East/Edmonton-Est"," 203","Edmonton",18,39,63,58,0,178,434
"Edmonton East/Edmonton-Est"," 204","Edmonton",10,37,54,40,0,141,334
"Edmonton East/Edmonton-Est"," 205","Edmonton",7,32,56,38,0,133,289
"Edmonton East/Edmonton-Est"," 206","Edmonton",10,28,67,39,2,146,450
"Edmonton East/Edmonton-Est"," 207","Edmonton",20,52,87,60,1,220,509
"Edmonton East/Edmonton-Est"," 208","Edmonton",19,39,80,53,3,194,442
"Edmonton East/Edmonton-Est"," 209","Edmonton",13,26,81,29,1,150,296
"Edmonton East/Edmonton-Est"," 210","Edmonton",15,37,50,52,1,155,446
"Edmonton East/Edmonton-Est"," 211A","Edmonton",22,36,39,47,1,145,321
"Edmonton East/Edmonton-Est"," 211B","Mobile poll/Bureau itinérant",Merged with No. 115B/Fusionné avec le nº 115B,,,,,,73
"Edmonton East/Edmonton-Est"," 212A","Edmonton",14,68,107,100,0,289,752
"Edmonton East/Edmonton-Est"," 212B","Mobile poll/Bureau itinérant",Merged with No. 213B/Fusionné avec le nº 213B,,,,,,60
"Edmonton East/Edmonton-Est"," 213A","Edmonton",18,37,48,32,2,137,345
"Edmonton East/Edmonton-Est"," 213B","Mobile poll/Bureau itinérant",13,16,28,183,6,246,115
"Edmonton East/Edmonton-Est"," 213C","Mobile poll/Bureau itinérant",Merged with No. 213B/Fusionné avec le nº 213B,,,,,,93
"Edmonton East/Edmonton-Est"," 213D","Mobile poll/Bureau itinérant",Merged with No. 213B/Fusionné avec le nº 213B,,,,,,44
"Edmonton East/Edmonton-Est"," 214","Edmonton",39,88,77,52,1,257,403
"Edmonton East/Edmonton-Est"," 215","Edmonton",22,98,57,42,0,219,345
"Edmonton East/Edmonton-Est"," 216A","Edmonton",24,83,76,44,0,227,327
"Edmonton East/Edmonton-Est"," 216B","Edmonton",33,71,76,58,1,239,334
"Edmonton East/Edmonton-Est"," 400","Edmonton",4,14,23,18,0,59,64
"Edmonton East/Edmonton-Est"," 500","Mobile poll/Bureau itinérant",4,14,93,41,0,152,214
"Edmonton East/Edmonton-Est"," 501","Mobile poll/Bureau itinérant",5,20,142,30,3,200,232
"Edmonton East/Edmonton-Est"," 502","Mobile poll/Bureau itinérant",2,10,33,29,4,78,122
"Edmonton East/Edmonton-Est"," 503","Mobile poll/Bureau itinérant",7,26,77,38,5,153,200
"Edmonton East/Edmonton-Est"," 504","Mobile poll/Bureau itinérant",5,22,82,43,1,153,209
"Edmonton East/Edmonton-Est"," 600","Edmonton",20,78,347,167,1,613,
"Edmonton East/Edmonton-Est"," 601","Edmonton",10,62,323,186,1,582,
"Edmonton East/Edmonton-Est"," 602","Edmonton",20,104,573,207,0,904,
"Edmonton East/Edmonton-Est"," 603","Edmonton",8,59,220,90,0,377,
"Edmonton East/Edmonton-Est"," 604","Edmonton",15,49,209,79,0,352,
"Edmonton East/Edmonton-Est"," 605","Edmonton",12,45,137,68,1,263,
"Edmonton East/Edmonton-Est"," 606","Edmonton",20,77,180,48,0,325,
"Edmonton East/Edmonton-Est"," 607","Edmonton",13,59,217,38,0,327,
"Edmonton East/Edmonton-Est"," 608","Edmonton",30,68,174,71,1,344,
"Edmonton East/Edmonton-Est"," 609","Edmonton",23,74,170,103,1,371,
"Edmonton East/Edmonton-Est",,Group 1/Groupe 1,20,26,68,100,18,232,423
"Edmonton East/Edmonton-Est",,Group 2/Groupe 2,34,137,698,238,19,1126,
